###############################
#p   1 ** *    *   *  * * *   #
# # # #*# # #*#*# # # #*#*#*# #
#  x*     ***  *  4   * *   * #
# # # # # #*# # #*#*# # # # #*#
#f         x **  *  *  3      #
# # # # # # # # # #*# #*# # # #
#*4 *  *   *  *  *   *   2    #
# # # # #*# # # #*#*# # # # # #
#*    **  *   4   *           #
# #*# # # # # # #*# # # # # # #
# **   3    *   *  *    2     #
###############################