###############################
#p   1 ** *    * 2 *  * * *   #
# # # #*# # #*#*# # # #*#*#*# #
#  x*     ***  *  1   * 2   * #
# # # # # #*# # #*#*# # # # #*#
#f         x **  *  *  3      #
# # # # # # # # # #*# #*# # # #
#*  *  *   *  *      *   2    #
# # # # #*# # # #*#*# # # # # #
#*    **  *   2   *           #
# #*# # # # # # #*# # # # # # #
# **   3    *   *  *    2     #
###############################